R 640 400
NO pics/redbrick.xpm
SO pics/colorstone.xpm
WE pics/bluebrick.xpm
EA pics/text1.xpm
S pics/barrel.xpm
F    243 ,  120 , 184
C 225 ,  30 ,                    0

   11111111111111
   100010000p0001
   10000200000001
   10000000020001
   10E00000000001
   10000000000001
   10000000000001
   10000000000111
   11111111111111
