R 640 400
NO ./path_to_the_north_texture
SO ./path_to_the_south_texture
WE ./path_to_the_west_texture
EA ./path_to_the_east_texture
S ./path_to_the_sprite_texture
F 220,220,80
C 225,30,0

   111111111
   100010001
   100000001
   100000001
   100000001
   100000001
   100000001
   100000001
   100N00111
   111111111
