R 1024 512
NO ./path_to_the_north_texture
SO ./path_to_the_south_texture
WE ./path_to_the_west_texture
EA ./path_to_the_east_texture
S ./path_to_the_sprite_texture
F 220,100,0
C 225,30,0

1111111111
1000000001
1020000001
1000000001
1000000001
10N0000001
1000000001
1111111111
1111111111
