
C 1 , 255,  1


NO          srcs/pics/wall1.xpm
SO srcs/pics/wall2.xpm

WE srcs/pics/wall3.xpm


R     1240  800

F 1 ,           255, 1
      EA srcs/pics/wall4.xpm


S srcs/pics/chat.xpm

   11111111111111
   10001000000001
   10000000000001
   1000W00000001
   10000000000001
   10000000000001
   10000000000001
   10000000000111
   11111111111111
